0000000000000000000
0111111111111111110
01CCCCCCCCCCCCCCC10
0111CCCCCCCCCCCCC10
01CCCCCCPCCCCCCCC10
0111CCCCCCECCCCCC10
01CCCCCCCCCCCCCCC10
0111111111111111110
0000000000000000000