111111111111
1000000C0P01
1C1110000C01
100011101111
100P111010E1
111111111111