111111111111
100000000001
101110000001
100011100001
100P111000E1
111111111111