111111111111
100000C00001
1C1110000001
100011100C01
1000111000E1
111111111111