111111111111
1000000C0001
111110000C01
100011101111
100P111010E1
111111111111