11111111111111111
10000000000000001
11100000000000001
1C00000P000000001
1110000C0E0000001
10000000000000001
11111111111111111