111111111111
1000000C0001
1C1110000001
X00011100C01
100P111000E1
111111111111