11111111111111111111111111111111111
10000000000000000000000000000000111
10000000000000000000000000000000111
10000000000000000000000000000000111
10000000000000000000000000000000111
10000000000000000000000000000000111
10000000000000000000000000000000111
10000000000000000000000000000000111
10000000000000000000000000000000111
10000000000000000000000000000000111
10000000000000000000000000000000111
100000000000000000C0000000000000111
10000000000000000000000000000000111
1000000000000000000000000000P000111
10000000000000000000000000000000111
10000000000000000000000000000000111
1000000000000000000000000E000000111
100000000000C0000000000000000000111
11111111111111111111111111111111111
