111111111111
1000000C0001
1C1110000001
100011101E11
100P111010C1
111111111111