111111111111
1000000C0001
1C1110000001
100011100C01
100P11100001
111111111111