111111111111
1000000C00011
1C11100000011
100011100C011
100P111000E1
111111111111