
111111111111
1000000C0001
1C1110000001
100011101011
100P111010E1
111111111111